S0W00000000000000000
00W0WWWWWWWWWWWWWW00
00W00000000000000W00
00W0WWWWWWWWWWWW0W00
00W00000000000000W00
00W000WWWWWWWWWWWW00
00W0000W000000000W00
00WWW00W00W0WWW00W00
00W0W00W00W000W00W00
00W0W00W00WWW0W00W00
00W0W0000000W0W00W00
00W0WWWWWWWWW0W00W00
00W00000000000W00W00
00WWWWWWWWWWWWW00W00
00000000000000000W0F